const unsigned char L9[] = {
0,0,0,0,0,0,0,0,0,0,0,0,0,0,0,0,
0,0,0,0,0,0,0,0,0,0,0,0,0,0,0,0,
0,0,0,0,0,0,0,0,0,0,0,0,0,0,0,0,
0,29,29,29,29,29,29,0,0,0,1,2,2,2,2,2,
0,0,0,0,0,0,0,0,0,0,9,10,10,10,10,10,
0,0,0,0,0,0,0,0,0,0,9,10,10,10,10,10,
0,0,0,0,0,0,0,0,0,0,9,10,10,10,10,10,
0,0,0,0,0,0,0,0,0,0,9,10,10,10,10,10,
2,2,2,2,2,2,2,2,2,2,17,10,10,18,5,5,
10,10,10,10,10,10,10,10,10,18,5,5,5,6,0,0,
10,10,10,10,10,10,10,10,10,11,0,0,0,0,0,0,
10,10,10,10,10,10,10,10,10,11,0,0,0,0,0,0,
10,10,10,10,10,10,10,10,10,11,0,0,0,0,0,0,
10,10,10,10,10,10,10,10,10,11,0,29,29,29,29,0,
10,10,10,10,10,10,10,10,10,11,0,0,0,0,0,0,
0,0,0,0,0,0,0,0,0,0,0,0,0,0,0,0
};